# of Sims,Tickets lost in this million,Total tickets lost,rolling ticket loss average,Expected Value this million,rolling expected value
1000000,-1190021,-1190021,-1190021.0,-1.190021,-1.190021
2000000,-1190597,-2380618,-1190309.0,-1.190597,-1.190309
3000000,-1189490,-3570108,-1190036.0,-1.18949,-1.190036
4000000,-1187344,-4757452,-1189363.0,-1.187344,-1.189363
5000000,-1191605,-5949057,-1189811.4,-1.191605,-1.1898114
6000000,-1187385,-7136442,-1189407.0,-1.187385,-1.189407
7000000,-1188508,-8324950,-1189278.5714285714,-1.188508,-1.1892785714285714
8000000,-1190786,-9515736,-1189467.0,-1.190786,-1.189467
9000000,-1189510,-10705246,-1189471.7777777778,-1.18951,-1.1894717777777777
10000000,-1189060,-11894306,-1189430.6,-1.18906,-1.1894306
11000000,-1193102,-13087408,-1189764.3636363635,-1.193102,-1.1897643636363637
12000000,-1189763,-14277171,-1189764.25,-1.189763,-1.18976425
13000000,-1188231,-15465402,-1189646.3076923077,-1.188231,-1.1896463076923076
14000000,-1190479,-16655881,-1189705.7857142857,-1.190479,-1.1897057857142856
15000000,-1190195,-17846076,-1189738.4,-1.190195,-1.1897384
16000000,-1194587,-19040663,-1190041.4375,-1.194587,-1.1900414375
17000000,-1191280,-20231943,-1190114.294117647,-1.19128,-1.190114294117647
18000000,-1188475,-21420418,-1190023.2222222222,-1.188475,-1.1900232222222222
19000000,-1192888,-22613306,-1190174.0,-1.192888,-1.190174
20000000,-1189057,-23802363,-1190118.15,-1.189057,-1.19011815
21000000,-1189092,-24991455,-1190069.2857142857,-1.189092,-1.1900692857142856
22000000,-1189811,-26181266,-1190057.5454545454,-1.189811,-1.1900575454545455
23000000,-1192364,-27373630,-1190157.8260869565,-1.192364,-1.1901578260869565
24000000,-1194773,-28568403,-1190350.125,-1.194773,-1.190350125
25000000,-1189608,-29758011,-1190320.44,-1.189608,-1.19032044
26000000,-1188015,-30946026,-1190231.7692307692,-1.188015,-1.1902317692307691
27000000,-1188577,-32134603,-1190170.4814814816,-1.188577,-1.1901704814814815
28000000,-1191140,-33325743,-1190205.107142857,-1.19114,-1.1902051071428572
29000000,-1190144,-34515887,-1190203.0,-1.190144,-1.190203
30000000,-1190534,-35706421,-1190214.0333333334,-1.190534,-1.1902140333333333
31000000,-1186374,-36892795,-1190090.1612903227,-1.186374,-1.1900901612903225
32000000,-1190630,-38083425,-1190107.03125,-1.19063,-1.19010703125
33000000,-1189914,-39273339,-1190101.1818181819,-1.189914,-1.190101181818182
34000000,-1188604,-40461943,-1190057.1470588236,-1.188604,-1.1900571470588235
35000000,-1190126,-41652069,-1190059.1142857142,-1.190126,-1.1900591142857142
36000000,-1190655,-42842724,-1190075.6666666667,-1.190655,-1.1900756666666668
37000000,-1189805,-44032529,-1190068.3513513512,-1.189805,-1.1900683513513513
38000000,-1190214,-45222743,-1190072.1842105263,-1.190214,-1.1900721842105264
39000000,-1189250,-46411993,-1190051.1025641025,-1.18925,-1.1900511025641025
40000000,-1189214,-47601207,-1190030.175,-1.189214,-1.190030175
41000000,-1190478,-48791685,-1190041.0975609757,-1.190478,-1.1900410975609756
42000000,-1191456,-49983141,-1190074.7857142857,-1.191456,-1.1900747857142857
43000000,-1189377,-51172518,-1190058.558139535,-1.189377,-1.1900585581395349
44000000,-1191807,-52364325,-1190098.2954545454,-1.191807,-1.1900982954545454
45000000,-1190430,-53554755,-1190105.6666666667,-1.19043,-1.1901056666666667
46000000,-1188303,-54743058,-1190066.4782608696,-1.188303,-1.1900664782608696
47000000,-1188279,-55931337,-1190028.4468085107,-1.188279,-1.1900284468085107
48000000,-1188427,-57119764,-1189995.0833333333,-1.188427,-1.1899950833333333
49000000,-1190634,-58310398,-1190008.1224489796,-1.190634,-1.1900081224489796
50000000,-1189898,-59500296,-1190005.92,-1.189898,-1.19000592
51000000,-1188948,-60689244,-1189985.1764705882,-1.188948,-1.1899851764705882
52000000,-1188792,-61878036,-1189962.2307692308,-1.188792,-1.1899622307692308
53000000,-1190068,-63068104,-1189964.2264150945,-1.190068,-1.1899642264150943
54000000,-1190479,-64258583,-1189973.7592592593,-1.190479,-1.1899737592592592
55000000,-1188237,-65446820,-1189942.1818181819,-1.188237,-1.189942181818182
56000000,-1187611,-66634431,-1189900.5535714286,-1.187611,-1.1899005535714287
57000000,-1190166,-67824597,-1189905.2105263157,-1.190166,-1.1899052105263157
58000000,-1188373,-69012970,-1189878.7931034483,-1.188373,-1.1898787931034482
59000000,-1188521,-70201491,-1189855.779661017,-1.188521,-1.189855779661017
60000000,-1190171,-71391662,-1189861.0333333334,-1.190171,-1.1898610333333333
61000000,-1190613,-72582275,-1189873.3606557378,-1.190613,-1.1898733606557377
62000000,-1191170,-73773445,-1189894.2741935484,-1.19117,-1.1898942741935483
63000000,-1188810,-74962255,-1189877.0634920634,-1.18881,-1.1898770634920635
64000000,-1189170,-76151425,-1189866.015625,-1.18917,-1.189866015625
65000000,-1190897,-77342322,-1189881.8769230768,-1.190897,-1.189881876923077
66000000,-1188820,-78531142,-1189865.7878787878,-1.18882,-1.189865787878788
67000000,-1189665,-79720807,-1189862.791044776,-1.189665,-1.189862791044776
68000000,-1187381,-80908188,-1189826.294117647,-1.187381,-1.189826294117647
69000000,-1191177,-82099365,-1189845.8695652173,-1.191177,-1.1898458695652174
70000000,-1190218,-83289583,-1189851.1857142858,-1.190218,-1.1898511857142857
71000000,-1187650,-84477233,-1189820.1830985916,-1.18765,-1.1898201830985915
72000000,-1188310,-85665543,-1189799.2083333333,-1.18831,-1.1897992083333333
73000000,-1190435,-86855978,-1189807.917808219,-1.190435,-1.1898079178082193
74000000,-1187982,-88043960,-1189783.2432432433,-1.187982,-1.1897832432432431
75000000,-1189729,-89233689,-1189782.52,-1.189729,-1.18978252
76000000,-1189951,-90423640,-1189784.7368421052,-1.189951,-1.1897847368421053
77000000,-1192620,-91616260,-1189821.5584415584,-1.19262,-1.1898215584415583
78000000,-1192834,-92809094,-1189860.1794871795,-1.192834,-1.1898601794871795
79000000,-1192154,-94001248,-1189889.2151898735,-1.192154,-1.1898892151898735
80000000,-1190187,-95191435,-1189892.9375,-1.190187,-1.1898929375
81000000,-1189121,-96380556,-1189883.4074074074,-1.189121,-1.1898834074074074
82000000,-1189638,-97570194,-1189880.4146341463,-1.189638,-1.1898804146341464
83000000,-1188761,-98758955,-1189866.9277108433,-1.188761,-1.1898669277108433
84000000,-1187808,-99946763,-1189842.4166666667,-1.187808,-1.1898424166666666
85000000,-1189610,-101136373,-1189839.6823529413,-1.18961,-1.1898396823529411
86000000,-1194057,-102330430,-1189888.7209302327,-1.194057,-1.1898887209302325
87000000,-1190669,-103521099,-1189897.6896551724,-1.190669,-1.1898976896551725
88000000,-1188503,-104709602,-1189881.8409090908,-1.188503,-1.189881840909091
89000000,-1191578,-105901180,-1189900.8988764044,-1.191578,-1.1899008988764046
90000000,-1189999,-107091179,-1189901.9888888889,-1.189999,-1.1899019888888889
91000000,-1187331,-108278510,-1189873.7362637362,-1.187331,-1.1898737362637362
92000000,-1190558,-109469068,-1189881.1739130435,-1.190558,-1.1898811739130435
93000000,-1188758,-110657826,-1189869.0967741935,-1.188758,-1.1898690967741936
94000000,-1189306,-111847132,-1189863.1063829786,-1.189306,-1.1898631063829788
95000000,-1190036,-113037168,-1189864.9263157896,-1.190036,-1.1898649263157894
96000000,-1189602,-114226770,-1189862.1875,-1.189602,-1.1898621875
97000000,-1190218,-115416988,-1189865.855670103,-1.190218,-1.1898658556701032
98000000,-1192000,-116608988,-1189887.6326530613,-1.192,-1.1898876326530612
99000000,-1192279,-117801267,-1189911.7878787878,-1.192279,-1.189911787878788
100000000,-1193385,-118994652,-1189946.52,-1.193385,-1.18994652
101000000,-1188833,-120183485,-1189935.495049505,-1.188833,-1.189935495049505
102000000,-1187660,-121371145,-1189913.1862745099,-1.18766,-1.1899131862745098
103000000,-1190272,-122561417,-1189916.6699029126,-1.190272,-1.1899166699029127
104000000,-1192105,-123753522,-1189937.7115384615,-1.192105,-1.1899377115384615
105000000,-1189004,-124942526,-1189928.8190476191,-1.189004,-1.1899288190476192
106000000,-1191050,-126133576,-1189939.3962264152,-1.19105,-1.189939396226415
107000000,-1190020,-127323596,-1189940.1495327102,-1.19002,-1.1899401495327102
108000000,-1189280,-128512876,-1189934.037037037,-1.18928,-1.189934037037037
109000000,-1191462,-129704338,-1189948.0550458715,-1.191462,-1.1899480550458716
110000000,-1187915,-130892253,-1189929.5727272728,-1.187915,-1.1899295727272727
111000000,-1188242,-132080495,-1189914.3693693695,-1.188242,-1.1899143693693695
112000000,-1191812,-133272307,-1189931.3125,-1.191812,-1.1899313125
113000000,-1193280,-134465587,-1189960.9469026548,-1.19328,-1.1899609469026549
114000000,-1191197,-135656784,-1189971.7894736843,-1.191197,-1.1899717894736843
115000000,-1188527,-136845311,-1189959.2260869564,-1.188527,-1.1899592260869565
116000000,-1191843,-138037154,-1189975.4655172413,-1.191843,-1.1899754655172414
117000000,-1188659,-139225813,-1189964.2136752137,-1.188659,-1.1899642136752138
118000000,-1188891,-140414704,-1189955.1186440678,-1.188891,-1.1899551186440678
119000000,-1189173,-141603877,-1189948.5462184874,-1.189173,-1.1899485462184873
120000000,-1189488,-142793365,-1189944.7083333333,-1.189488,-1.1899447083333334
121000000,-1189603,-143982968,-1189941.8842975206,-1.189603,-1.1899418842975207
122000000,-1193225,-145176193,-1189968.7950819673,-1.193225,-1.1899687950819673
123000000,-1190405,-146366598,-1189972.3414634147,-1.190405,-1.1899723414634147
124000000,-1191551,-147558149,-1189985.072580645,-1.191551,-1.1899850725806451
125000000,-1189119,-148747268,-1189978.144,-1.189119,-1.189978144
126000000,-1190517,-149937785,-1189982.4206349207,-1.190517,-1.1899824206349205
127000000,-1189742,-151127527,-1189980.527559055,-1.189742,-1.1899805275590551
128000000,-1192156,-152319683,-1189997.5234375,-1.192156,-1.1899975234375
129000000,-1189059,-153508742,-1189990.2480620155,-1.189059,-1.1899902480620155
130000000,-1190163,-154698905,-1189991.576923077,-1.190163,-1.1899915769230769
131000000,-1186149,-155885054,-1189962.2442748093,-1.186149,-1.1899622442748092
132000000,-1189681,-157074735,-1189960.1136363635,-1.189681,-1.1899601136363636
133000000,-1187747,-158262482,-1189943.4736842106,-1.187747,-1.1899434736842105
134000000,-1189158,-159451640,-1189937.6119402985,-1.189158,-1.1899376119402985
135000000,-1192748,-160644388,-1189958.4296296297,-1.192748,-1.1899584296296297
136000000,-1190845,-161835233,-1189964.9485294118,-1.190845,-1.1899649485294117
137000000,-1189125,-163024358,-1189958.8175182482,-1.189125,-1.1899588175182483
138000000,-1187728,-164212086,-1189942.652173913,-1.187728,-1.1899426521739132
139000000,-1189920,-165402006,-1189942.489208633,-1.18992,-1.189942489208633
140000000,-1189783,-166591789,-1189941.35,-1.189783,-1.18994135
141000000,-1189890,-167781679,-1189940.9858156028,-1.18989,-1.189940985815603
142000000,-1188971,-168970650,-1189934.1549295774,-1.188971,-1.1899341549295774
143000000,-1192042,-170162692,-1189948.895104895,-1.192042,-1.189948895104895
144000000,-1191867,-171354559,-1189962.2152777778,-1.191867,-1.1899622152777778
145000000,-1190565,-172545124,-1189966.372413793,-1.190565,-1.189966372413793
146000000,-1189719,-173734843,-1189964.6780821919,-1.189719,-1.1899646780821918
147000000,-1189814,-174924657,-1189963.6530612244,-1.189814,-1.1899636530612245
148000000,-1190515,-176115172,-1189967.3783783785,-1.190515,-1.1899673783783784
149000000,-1190397,-177305569,-1189970.2617449665,-1.190397,-1.1899702617449663
150000000,-1193371,-178498940,-1189992.9333333333,-1.193371,-1.1899929333333332
151000000,-1186755,-179685695,-1189971.4900662252,-1.186755,-1.1899714900662253
152000000,-1190139,-180875834,-1189972.5921052631,-1.190139,-1.189972592105263
153000000,-1188687,-182064521,-1189964.1895424838,-1.188687,-1.1899641895424837
154000000,-1189165,-183253686,-1189959.0,-1.189165,-1.189959
155000000,-1190430,-184444116,-1189962.0387096775,-1.19043,-1.1899620387096774
156000000,-1191677,-185635793,-1189973.032051282,-1.191677,-1.189973032051282
157000000,-1190559,-186826352,-1189976.7643312102,-1.190559,-1.1899767643312102
158000000,-1190333,-188016685,-1189979.0189873418,-1.190333,-1.1899790189873418
159000000,-1189806,-189206491,-1189977.9308176101,-1.189806,-1.1899779308176102
160000000,-1188891,-190395382,-1189971.1375,-1.188891,-1.1899711375
161000000,-1191321,-191586703,-1189979.5217391304,-1.191321,-1.1899795217391305
162000000,-1190692,-192777395,-1189983.9197530865,-1.190692,-1.1899839197530864
163000000,-1187827,-193965222,-1189970.6871165645,-1.187827,-1.1899706871165645
164000000,-1188338,-195153560,-1189960.731707317,-1.188338,-1.189960731707317
165000000,-1191814,-196345374,-1189971.9636363636,-1.191814,-1.1899719636363637
166000000,-1189520,-197534894,-1189969.2409638555,-1.18952,-1.1899692409638554
167000000,-1188069,-198722963,-1189957.862275449,-1.188069,-1.1899578622754492
168000000,-1188183,-199911146,-1189947.2976190476,-1.188183,-1.1899472976190477
169000000,-1191283,-201102429,-1189955.201183432,-1.191283,-1.189955201183432
170000000,-1189278,-202291707,-1189951.217647059,-1.189278,-1.1899512176470588
171000000,-1189579,-203481286,-1189949.0409356726,-1.189579,-1.1899490409356726
172000000,-1187595,-204668881,-1189935.3546511629,-1.187595,-1.1899353546511628
173000000,-1189245,-205858126,-1189931.3641618497,-1.189245,-1.1899313641618496
174000000,-1192140,-207050266,-1189944.0574712644,-1.19214,-1.1899440574712643
175000000,-1187772,-208238038,-1189931.6457142858,-1.187772,-1.1899316457142857
176000000,-1189180,-209427218,-1189927.375,-1.18918,-1.189927375
177000000,-1191415,-210618633,-1189935.779661017,-1.191415,-1.189935779661017
178000000,-1192021,-211810654,-1189947.4943820224,-1.192021,-1.1899474943820225
179000000,-1191127,-213001781,-1189954.0837988828,-1.191127,-1.1899540837988827
180000000,-1190193,-214191974,-1189955.411111111,-1.190193,-1.189955411111111
181000000,-1190977,-215382951,-1189961.0552486188,-1.190977,-1.1899610552486188
182000000,-1191886,-216574837,-1189971.631868132,-1.191886,-1.189971631868132
183000000,-1189410,-217764247,-1189968.56284153,-1.18941,-1.18996856284153
184000000,-1190607,-218954854,-1189972.0326086956,-1.190607,-1.1899720326086956
185000000,-1192216,-220147070,-1189984.1621621621,-1.192216,-1.189984162162162
186000000,-1189804,-221336874,-1189983.1935483871,-1.189804,-1.189983193548387
187000000,-1188762,-222525636,-1189976.6631016042,-1.188762,-1.1899766631016042
188000000,-1189220,-223714856,-1189972.6382978724,-1.18922,-1.1899726382978724
189000000,-1191020,-224905876,-1189978.1798941798,-1.19102,-1.18997817989418
190000000,-1188929,-226094805,-1189972.6578947369,-1.188929,-1.189972657894737
191000000,-1191812,-227286617,-1189982.287958115,-1.191812,-1.1899822879581152
192000000,-1189504,-228476121,-1189979.796875,-1.189504,-1.189979796875
193000000,-1189051,-229665172,-1189974.9844559585,-1.189051,-1.1899749844559586
194000000,-1188875,-230854047,-1189969.3144329898,-1.188875,-1.1899693144329897
195000000,-1192814,-232046861,-1189983.9025641026,-1.192814,-1.1899839025641026
196000000,-1190258,-233237119,-1189985.301020408,-1.190258,-1.1899853010204082
197000000,-1190356,-234427475,-1189987.1827411167,-1.190356,-1.1899871827411168
198000000,-1190872,-235618347,-1189991.6515151516,-1.190872,-1.1899916515151514
199000000,-1187469,-236805816,-1189978.974874372,-1.187469,-1.1899789748743719
200000000,-1190032,-237995848,-1189979.24,-1.190032,-1.18997924
201000000,-1188773,-239184621,-1189973.2388059702,-1.188773,-1.18997323880597
202000000,-1189713,-240374334,-1189971.9504950496,-1.189713,-1.1899719504950494
203000000,-1188549,-241562883,-1189964.9408866996,-1.188549,-1.1899649408866995
204000000,-1186466,-242749349,-1189947.7892156863,-1.186466,-1.1899477892156862
205000000,-1189792,-243939141,-1189947.0292682927,-1.189792,-1.1899470292682928
206000000,-1190295,-245129436,-1189948.7184466019,-1.190295,-1.189948718446602
207000000,-1193269,-246322705,-1189964.7584541063,-1.193269,-1.1899647584541062
208000000,-1189048,-247511753,-1189960.3509615385,-1.189048,-1.1899603509615384
209000000,-1190996,-248702749,-1189965.3062200956,-1.190996,-1.1899653062200957
210000000,-1191553,-249894302,-1189972.8666666667,-1.191553,-1.1899728666666667
211000000,-1188236,-251082538,-1189964.63507109,-1.188236,-1.18996463507109
212000000,-1190208,-252272746,-1189965.783018868,-1.190208,-1.189965783018868
213000000,-1188771,-253461517,-1189960.1737089201,-1.188771,-1.1899601737089203
214000000,-1190189,-254651706,-1189961.2429906542,-1.190189,-1.1899612429906543
215000000,-1190574,-255842280,-1189964.0930232557,-1.190574,-1.1899640930232558
216000000,-1188720,-257031000,-1189958.3333333333,-1.18872,-1.1899583333333332
217000000,-1190884,-258221884,-1189962.599078341,-1.190884,-1.1899625990783411
218000000,-1190751,-259412635,-1189966.2155963304,-1.190751,-1.1899662155963302
219000000,-1191435,-260604070,-1189972.9223744292,-1.191435,-1.1899729223744293
220000000,-1190140,-261794210,-1189973.6818181819,-1.19014,-1.1899736818181819
221000000,-1190823,-262985033,-1189977.5248868777,-1.190823,-1.1899775248868778
222000000,-1193020,-264178053,-1189991.2297297297,-1.19302,-1.1899912297297297
223000000,-1193540,-265371593,-1190007.1434977578,-1.19354,-1.190007143497758
224000000,-1188585,-266560178,-1190000.794642857,-1.188585,-1.1900007946428572
225000000,-1191091,-267751269,-1190005.64,-1.191091,-1.19000564
226000000,-1189254,-268940523,-1190002.314159292,-1.189254,-1.1900023141592921
227000000,-1192519,-270133042,-1190013.4008810574,-1.192519,-1.1900134008810572
228000000,-1190020,-271323062,-1190013.4298245613,-1.19002,-1.1900134298245615
229000000,-1191704,-272514766,-1190020.8122270743,-1.191704,-1.1900208122270743
230000000,-1190155,-273704921,-1190021.395652174,-1.190155,-1.190021395652174
231000000,-1192114,-274897035,-1190030.4545454546,-1.192114,-1.1900304545454545
232000000,-1188995,-276086030,-1190025.9913793104,-1.188995,-1.1900259913793103
233000000,-1191677,-277277707,-1190033.077253219,-1.191677,-1.1900330772532188
234000000,-1189643,-278467350,-1190031.4102564103,-1.189643,-1.1900314102564102
235000000,-1191229,-279658579,-1190036.5063829788,-1.191229,-1.1900365063829788
236000000,-1188866,-280847445,-1190031.5466101696,-1.188866,-1.1900315466101694
237000000,-1193188,-282040633,-1190044.864978903,-1.193188,-1.190044864978903
238000000,-1189095,-283229728,-1190040.87394958,-1.189095,-1.1900408739495798
239000000,-1190088,-284419816,-1190041.0711297072,-1.190088,-1.1900410711297071
240000000,-1191049,-285610865,-1190045.2708333333,-1.191049,-1.1900452708333333
241000000,-1188757,-286799622,-1190039.9253112033,-1.188757,-1.1900399253112033
242000000,-1187665,-287987287,-1190030.111570248,-1.187665,-1.1900301115702479
243000000,-1189270,-289176557,-1190026.9835390947,-1.18927,-1.1900269835390946
244000000,-1189667,-290366224,-1190025.5081967213,-1.189667,-1.1900255081967213
245000000,-1189007,-291555231,-1190021.351020408,-1.189007,-1.190021351020408
246000000,-1190895,-292746126,-1190024.9024390243,-1.190895,-1.1900249024390244
247000000,-1192292,-293938418,-1190034.0809716599,-1.192292,-1.1900340809716599
248000000,-1190755,-295129173,-1190036.9879032257,-1.190755,-1.1900369879032258
249000000,-1192028,-296321201,-1190044.9839357429,-1.192028,-1.190044983935743
250000000,-1186052,-297507253,-1190029.012,-1.186052,-1.190029012
251000000,-1191493,-298698746,-1190034.844621514,-1.191493,-1.1900348446215139
252000000,-1188789,-299887535,-1190029.900793651,-1.188789,-1.1900299007936508
253000000,-1185607,-301073142,-1190012.418972332,-1.185607,-1.190012418972332
254000000,-1192305,-302265447,-1190021.4448818897,-1.192305,-1.1900214448818898
255000000,-1189469,-303454916,-1190019.2784313725,-1.189469,-1.1900192784313726
256000000,-1186546,-304641462,-1190005.7109375,-1.186546,-1.1900057109375
257000000,-1191022,-305832484,-1190009.6653696499,-1.191022,-1.19000966536965
258000000,-1188633,-307021117,-1190004.3294573643,-1.188633,-1.1900043294573643
259000000,-1186570,-308207687,-1189991.0694980696,-1.18657,-1.1899910694980695
260000000,-1191956,-309399643,-1189998.6269230768,-1.191956,-1.189998626923077
261000000,-1191857,-310591500,-1190005.7471264368,-1.191857,-1.1900057471264367
262000000,-1189953,-311781453,-1190005.5458015266,-1.189953,-1.1900055458015266
263000000,-1189466,-312970919,-1190003.494296578,-1.189466,-1.190003494296578
264000000,-1188780,-314159699,-1189998.8598484849,-1.18878,-1.1899988598484847
265000000,-1191383,-315351082,-1190004.083018868,-1.191383,-1.1900040830188678
266000000,-1190724,-316541806,-1190006.7894736843,-1.190724,-1.190006789473684
267000000,-1188492,-317730298,-1190001.116104869,-1.188492,-1.190001116104869
268000000,-1192788,-318923086,-1190011.514925373,-1.192788,-1.1900115149253732
269000000,-1188281,-320111367,-1190005.0817843867,-1.188281,-1.1900050817843866
270000000,-1191661,-321303028,-1190011.2148148147,-1.191661,-1.1900112148148148
271000000,-1188545,-322491573,-1190005.8044280442,-1.188545,-1.1900058044280444
272000000,-1190157,-323681730,-1190006.3602941176,-1.190157,-1.1900063602941175
273000000,-1190083,-324871813,-1190006.641025641,-1.190083,-1.1900066410256411
274000000,-1188732,-326060545,-1190001.989051095,-1.188732,-1.1900019890510949
275000000,-1189401,-327249946,-1189999.8036363637,-1.189401,-1.1899998036363637
276000000,-1188091,-328438037,-1189992.8876811594,-1.188091,-1.1899928876811594
277000000,-1192467,-329630504,-1190001.8194945848,-1.192467,-1.190001819494585
278000000,-1191961,-330822465,-1190008.8669064748,-1.191961,-1.1900088669064748
279000000,-1186973,-332009438,-1189997.9856630825,-1.186973,-1.1899979856630825
280000000,-1187702,-333197140,-1189989.7857142857,-1.187702,-1.1899897857142858
281000000,-1189714,-334386854,-1189988.8042704626,-1.189714,-1.1899888042704627
282000000,-1191151,-335578005,-1189992.925531915,-1.191151,-1.1899929255319148
283000000,-1189866,-336767871,-1189992.477031802,-1.189866,-1.1899924770318022
284000000,-1192068,-337959939,-1189999.7852112676,-1.192068,-1.1899997852112676
285000000,-1187454,-339147393,-1189990.852631579,-1.187454,-1.189990852631579
286000000,-1189393,-340336786,-1189988.7622377623,-1.189393,-1.1899887622377623
287000000,-1191221,-341528007,-1189993.0557491288,-1.191221,-1.189993055749129
288000000,-1185515,-342713522,-1189977.5069444445,-1.185515,-1.1899775069444445
289000000,-1192177,-343905699,-1189985.1176470588,-1.192177,-1.1899851176470588
290000000,-1190294,-345095993,-1189986.1827586207,-1.190294,-1.1899861827586207
291000000,-1187114,-346283107,-1189976.3127147767,-1.187114,-1.1899763127147767
292000000,-1191203,-347474310,-1189980.51369863,-1.191203,-1.1899805136986301
293000000,-1189352,-348663662,-1189978.3686006826,-1.189352,-1.1899783686006826
294000000,-1187807,-349851469,-1189970.9829931974,-1.187807,-1.1899709829931973
295000000,-1189762,-351041231,-1189970.2745762712,-1.189762,-1.1899702745762712
296000000,-1189141,-352230372,-1189967.472972973,-1.189141,-1.189967472972973
297000000,-1187953,-353418325,-1189960.6902356902,-1.187953,-1.1899606902356903
298000000,-1188409,-354606734,-1189955.4832214764,-1.188409,-1.1899554832214765
299000000,-1193210,-355799944,-1189966.3678929766,-1.19321,-1.1899663678929766
300000000,-1189281,-356989225,-1189964.0833333333,-1.189281,-1.1899640833333334
301000000,-1188103,-358177328,-1189957.900332226,-1.188103,-1.1899579003322258
302000000,-1189232,-359366560,-1189955.4966887417,-1.189232,-1.1899554966887418
303000000,-1191081,-360557641,-1189959.2112211222,-1.191081,-1.1899592112211221
304000000,-1191930,-361749571,-1189965.6940789474,-1.19193,-1.1899656940789474
305000000,-1192232,-362941803,-1189973.124590164,-1.192232,-1.189973124590164
306000000,-1189573,-364131376,-1189971.816993464,-1.189573,-1.189971816993464
307000000,-1190692,-365322068,-1189974.1628664494,-1.190692,-1.1899741628664495
308000000,-1190216,-366512284,-1189974.948051948,-1.190216,-1.1899749480519481
309000000,-1191393,-367703677,-1189979.5372168284,-1.191393,-1.1899795372168285
310000000,-1187863,-368891540,-1189972.7096774194,-1.187863,-1.1899727096774193
311000000,-1192667,-370084207,-1189981.3729903537,-1.192667,-1.1899813729903537
312000000,-1188647,-371272854,-1189977.0961538462,-1.188647,-1.189977096153846
313000000,-1187827,-372460681,-1189970.2268370606,-1.187827,-1.1899702268370607
314000000,-1192999,-373653680,-1189979.872611465,-1.192999,-1.189979872611465
315000000,-1190539,-374844219,-1189981.6476190477,-1.190539,-1.1899816476190477
316000000,-1191117,-376035336,-1189985.240506329,-1.191117,-1.1899852405063291
317000000,-1192394,-377227730,-1189992.8391167193,-1.192394,-1.1899928391167192
318000000,-1188468,-378416198,-1189988.0440251573,-1.188468,-1.1899880440251573
319000000,-1188343,-379604541,-1189982.8871473353,-1.188343,-1.1899828871473355
320000000,-1188901,-380793442,-1189979.50625,-1.188901,-1.18997950625
321000000,-1187296,-381980738,-1189971.1464174455,-1.187296,-1.1899711464174454
322000000,-1192289,-383173027,-1189978.3447204968,-1.192289,-1.1899783447204968
323000000,-1190342,-384363369,-1189979.4705882352,-1.190342,-1.1899794705882354
324000000,-1188710,-385552079,-1189975.5524691357,-1.18871,-1.1899755524691358
325000000,-1191538,-386743617,-1189980.36,-1.191538,-1.18998036
326000000,-1191454,-387935071,-1189984.8803680982,-1.191454,-1.1899848803680981
327000000,-1192425,-389127496,-1189992.3425076453,-1.192425,-1.1899923425076453
328000000,-1192168,-390319664,-1189998.975609756,-1.192168,-1.1899989756097562
329000000,-1190948,-391510612,-1190001.8601823708,-1.190948,-1.1900018601823708
330000000,-1188849,-392699461,-1189998.3666666667,-1.188849,-1.1899983666666667
331000000,-1191401,-393890862,-1190002.6042296072,-1.191401,-1.1900026042296072
332000000,-1188856,-395079718,-1189999.1506024096,-1.188856,-1.1899991506024097
333000000,-1190067,-396269785,-1189999.3543543543,-1.190067,-1.1899993543543543
334000000,-1193941,-397463726,-1190011.1556886227,-1.193941,-1.1900111556886228
335000000,-1191572,-398655298,-1190015.814925373,-1.191572,-1.1900158149253732
336000000,-1189928,-399845226,-1190015.5535714286,-1.189928,-1.1900155535714285
337000000,-1193575,-401038801,-1190026.115727003,-1.193575,-1.190026115727003
338000000,-1186786,-402225587,-1190016.5295857987,-1.186786,-1.1900165295857987
339000000,-1189998,-403415585,-1190016.4749262538,-1.189998,-1.1900164749262536
340000000,-1188563,-404604148,-1190012.2,-1.188563,-1.1900122
341000000,-1190043,-405794191,-1190012.2903225806,-1.190043,-1.1900122903225807
342000000,-1188460,-406982651,-1190007.7514619883,-1.18846,-1.1900077514619882
343000000,-1192315,-408174966,-1190014.4781341108,-1.192315,-1.1900144781341109
344000000,-1188859,-409363825,-1190011.1191860465,-1.188859,-1.1900111191860465
345000000,-1191475,-410555300,-1190015.3623188406,-1.191475,-1.1900153623188405
346000000,-1190830,-411746130,-1190017.7167630058,-1.19083,-1.1900177167630057
347000000,-1190044,-412936174,-1190017.7925072047,-1.190044,-1.1900177925072046
348000000,-1189073,-414125247,-1190015.0775862068,-1.189073,-1.1900150775862068
349000000,-1190118,-415315365,-1190015.3724928368,-1.190118,-1.1900153724928366
350000000,-1188678,-416504043,-1190011.5514285713,-1.188678,-1.1900115514285714
351000000,-1190162,-417694205,-1190011.9800569802,-1.190162,-1.1900119800569802
352000000,-1188407,-418882612,-1190007.4204545454,-1.188407,-1.1900074204545454
353000000,-1191510,-420074122,-1190011.6770538243,-1.19151,-1.1900116770538243
354000000,-1189266,-421263388,-1190009.5706214688,-1.189266,-1.1900095706214688
355000000,-1187019,-422450407,-1190001.1464788732,-1.187019,-1.1900011464788733
356000000,-1192399,-423642806,-1190007.8820224719,-1.192399,-1.190007882022472
357000000,-1188572,-424831378,-1190003.8599439776,-1.188572,-1.1900038599439775
358000000,-1191101,-426022479,-1190006.9245810055,-1.191101,-1.1900069245810057
359000000,-1190161,-427212640,-1190007.3537604457,-1.190161,-1.1900073537604456
360000000,-1189408,-428402048,-1190005.6888888888,-1.189408,-1.1900056888888888
361000000,-1190535,-429592583,-1190007.1551246538,-1.190535,-1.1900071551246538
362000000,-1188439,-430781022,-1190002.8232044198,-1.188439,-1.19000282320442
363000000,-1187559,-431968581,-1189996.0909090908,-1.187559,-1.189996090909091
364000000,-1191851,-433160432,-1190001.1868131869,-1.191851,-1.1900011868131868
365000000,-1190160,-434350592,-1190001.6219178082,-1.19016,-1.1900016219178082
366000000,-1193855,-435544447,-1190012.150273224,-1.193855,-1.190012150273224
367000000,-1188098,-436732545,-1190006.9346049046,-1.188098,-1.1900069346049047
368000000,-1188364,-437920909,-1190002.4701086956,-1.188364,-1.1900024701086958
369000000,-1189678,-439110587,-1190001.5907859078,-1.189678,-1.1900015907859078
370000000,-1189092,-440299679,-1189999.1324324324,-1.189092,-1.1899991324324324
371000000,-1190736,-441490415,-1190001.1185983827,-1.190736,-1.1900011185983828
372000000,-1190360,-442680775,-1190002.0833333333,-1.19036,-1.1900020833333333
373000000,-1191121,-443871896,-1190005.0831099197,-1.191121,-1.1900050831099196
374000000,-1193064,-445064960,-1190013.2620320856,-1.193064,-1.1900132620320856
375000000,-1188637,-446253597,-1190009.592,-1.188637,-1.190009592
376000000,-1191417,-447445014,-1190013.335106383,-1.191417,-1.190013335106383
377000000,-1190431,-448635445,-1190014.4429708223,-1.190431,-1.1900144429708224
378000000,-1190500,-449825945,-1190015.7275132276,-1.1905,-1.1900157275132275
379000000,-1192775,-451018720,-1190023.0079155674,-1.192775,-1.1900230079155674
380000000,-1191140,-452209860,-1190025.9473684211,-1.19114,-1.1900259473684212
381000000,-1190331,-453400191,-1190026.748031496,-1.190331,-1.190026748031496
382000000,-1190146,-454590337,-1190027.060209424,-1.190146,-1.190027060209424
383000000,-1190143,-455780480,-1190027.362924282,-1.190143,-1.190027362924282
384000000,-1189384,-456969864,-1190025.6875,-1.189384,-1.1900256875
385000000,-1188660,-458158524,-1190022.1402597402,-1.18866,-1.1900221402597402
386000000,-1191605,-459350129,-1190026.2409326425,-1.191605,-1.1900262409326425
387000000,-1189485,-460539614,-1190024.842377261,-1.189485,-1.190024842377261
388000000,-1190470,-461730084,-1190025.9896907217,-1.19047,-1.1900259896907217
389000000,-1191023,-462921107,-1190028.5526992287,-1.191023,-1.1900285526992287
390000000,-1190027,-464111134,-1190028.5487179486,-1.190027,-1.1900285487179487
391000000,-1189285,-465300419,-1190026.6470588236,-1.189285,-1.1900266470588234
392000000,-1190859,-466491278,-1190028.7704081633,-1.190859,-1.1900287704081633
393000000,-1188849,-467680127,-1190025.768447837,-1.188849,-1.1900257684478373
394000000,-1192787,-468872914,-1190032.776649746,-1.192787,-1.1900327766497463
395000000,-1192779,-470065693,-1190039.729113924,-1.192779,-1.190039729113924
396000000,-1189943,-471255636,-1190039.4848484849,-1.189943,-1.1900394848484848
397000000,-1189402,-472445038,-1190037.879093199,-1.189402,-1.190037879093199
398000000,-1190831,-473635869,-1190039.8718592965,-1.190831,-1.1900398718592964
399000000,-1187736,-474823605,-1190034.0977443608,-1.187736,-1.1900340977443609
400000000,-1188098,-476011703,-1190029.2575,-1.188098,-1.1900292575
401000000,-1192028,-477203731,-1190034.241895262,-1.192028,-1.1900342418952619
402000000,-1190561,-478394292,-1190035.552238806,-1.190561,-1.190035552238806
403000000,-1190357,-479584649,-1190036.3498759305,-1.190357,-1.1900363498759305
404000000,-1187371,-480772020,-1190029.7524752475,-1.187371,-1.1900297524752474
405000000,-1189747,-481961767,-1190029.0543209875,-1.189747,-1.1900290543209877
406000000,-1188499,-483150266,-1190025.2857142857,-1.188499,-1.1900252857142857
407000000,-1188738,-484339004,-1190022.1228501229,-1.188738,-1.1900221228501229
408000000,-1192595,-485531599,-1190028.4289215687,-1.192595,-1.1900284289215686
409000000,-1192455,-486724054,-1190034.3618581907,-1.192455,-1.1900343618581908
410000000,-1187531,-487911585,-1190028.256097561,-1.187531,-1.190028256097561
411000000,-1190872,-489102457,-1190030.3090024332,-1.190872,-1.1900303090024331
412000000,-1189133,-490291590,-1190028.1310679612,-1.189133,-1.1900281310679612
413000000,-1190089,-491481679,-1190028.278450363,-1.190089,-1.1900282784503633
414000000,-1189226,-492670905,-1190026.3405797102,-1.189226,-1.1900263405797102
415000000,-1193266,-493864171,-1190034.1469879518,-1.193266,-1.1900341469879518
416000000,-1190642,-495054813,-1190035.608173077,-1.190642,-1.190035608173077
417000000,-1191885,-496246698,-1190040.0431654677,-1.191885,-1.1900400431654676
418000000,-1187773,-497434471,-1190034.619617225,-1.187773,-1.190034619617225
419000000,-1186523,-498620994,-1190026.2386634846,-1.186523,-1.1900262386634846
420000000,-1192073,-499813067,-1190031.111904762,-1.192073,-1.190031111904762
421000000,-1190766,-501003833,-1190032.8574821854,-1.190766,-1.1900328574821852
422000000,-1188902,-502192735,-1190030.1777251186,-1.188902,-1.1900301777251185
423000000,-1188235,-503380970,-1190025.9338061465,-1.188235,-1.1900259338061465
424000000,-1192631,-504573601,-1190032.0778301887,-1.192631,-1.1900320778301887
425000000,-1188293,-505761894,-1190027.985882353,-1.188293,-1.190027985882353
426000000,-1189559,-506951453,-1190026.8849765258,-1.189559,-1.1900268849765259
427000000,-1192074,-508143527,-1190031.6791569088,-1.192074,-1.1900316791569088
428000000,-1191509,-509335036,-1190035.1308411215,-1.191509,-1.1900351308411214
429000000,-1191013,-510526049,-1190037.4102564103,-1.191013,-1.1900374102564102
430000000,-1190558,-511716607,-1190038.6209302326,-1.190558,-1.1900386209302325
431000000,-1190989,-512907596,-1190040.825986079,-1.190989,-1.1900408259860789
432000000,-1190510,-514098106,-1190041.912037037,-1.19051,-1.1900419120370371
433000000,-1191332,-515289438,-1190044.8914549653,-1.191332,-1.1900448914549653
434000000,-1189020,-516478458,-1190042.529953917,-1.18902,-1.190042529953917
435000000,-1188335,-517666793,-1190038.6045977012,-1.188335,-1.1900386045977012
436000000,-1187618,-518854411,-1190033.0527522936,-1.187618,-1.1900330527522935
437000000,-1192683,-520047094,-1190039.1167048055,-1.192683,-1.1900391167048054
438000000,-1189361,-521236455,-1190037.5684931506,-1.189361,-1.1900375684931508
439000000,-1193861,-522430316,-1190046.277904328,-1.193861,-1.190046277904328
440000000,-1190276,-523620592,-1190046.8,-1.190276,-1.1900468
441000000,-1188770,-524809362,-1190043.9047619049,-1.18877,-1.1900439047619047
442000000,-1193712,-526003074,-1190052.2036199095,-1.193712,-1.1900522036199095
443000000,-1189453,-527192527,-1190050.8510158013,-1.189453,-1.1900508510158014
444000000,-1190240,-528382767,-1190051.277027027,-1.19024,-1.190051277027027
445000000,-1191430,-529574197,-1190054.3752808988,-1.19143,-1.190054375280899
446000000,-1188324,-530762521,-1190050.495515695,-1.188324,-1.190050495515695
447000000,-1190041,-531952562,-1190050.4742729308,-1.190041,-1.1900504742729308
448000000,-1190971,-533143533,-1190052.529017857,-1.190971,-1.1900525290178572
449000000,-1187472,-534331005,-1190046.7817371937,-1.187472,-1.1900467817371938
450000000,-1187819,-535518824,-1190041.8311111112,-1.187819,-1.1900418311111112
451000000,-1190070,-536708894,-1190041.8935698448,-1.19007,-1.1900418935698447
452000000,-1190954,-537899848,-1190043.9115044249,-1.190954,-1.1900439115044248
453000000,-1190674,-539090522,-1190045.302428256,-1.190674,-1.190045302428256
454000000,-1190985,-540281507,-1190047.3722466961,-1.190985,-1.190047372246696
455000000,-1187367,-541468874,-1190041.4813186813,-1.187367,-1.1900414813186813
456000000,-1189472,-542658346,-1190040.2324561405,-1.189472,-1.1900402324561403
457000000,-1188769,-543847115,-1190037.4507658642,-1.188769,-1.1900374507658644
458000000,-1190162,-545037277,-1190037.7227074236,-1.190162,-1.1900377227074235
459000000,-1190648,-546227925,-1190039.0522875816,-1.190648,-1.1900390522875817
460000000,-1188542,-547416467,-1190035.7978260869,-1.188542,-1.190035797826087
461000000,-1188853,-548605320,-1190033.2321041215,-1.188853,-1.1900332321041214
462000000,-1188334,-549793654,-1190029.554112554,-1.188334,-1.190029554112554
463000000,-1190284,-550983938,-1190030.1036717063,-1.190284,-1.1900301036717063
464000000,-1192545,-552176483,-1190035.5237068965,-1.192545,-1.1900355237068965
465000000,-1190384,-553366867,-1190036.2731182796,-1.190384,-1.1900362731182796
466000000,-1188454,-554555321,-1190032.8776824034,-1.188454,-1.1900328776824034
467000000,-1191762,-555747083,-1190036.5802997858,-1.191762,-1.1900365802997859
468000000,-1188433,-556935516,-1190033.1538461538,-1.188433,-1.190033153846154
469000000,-1188393,-558123909,-1190029.656716418,-1.188393,-1.190029656716418
470000000,-1192418,-559316327,-1190034.7382978722,-1.192418,-1.1900347382978724
471000000,-1188540,-560504867,-1190031.5647558386,-1.18854,-1.1900315647558386
472000000,-1189427,-561694294,-1190030.2838983051,-1.189427,-1.190030283898305
473000000,-1187844,-562882138,-1190025.6617336152,-1.187844,-1.1900256617336151
474000000,-1189338,-564071476,-1190024.2109704642,-1.189338,-1.1900242109704642
475000000,-1190049,-565261525,-1190024.2631578948,-1.190049,-1.1900242631578948
476000000,-1187447,-566448972,-1190018.8487394957,-1.187447,-1.1900188487394958
477000000,-1189322,-567638294,-1190017.3878406708,-1.189322,-1.1900173878406708
478000000,-1187693,-568825987,-1190012.5251046026,-1.187693,-1.1900125251046025
479000000,-1191958,-570017945,-1190016.5866388308,-1.191958,-1.1900165866388308
480000000,-1190096,-571208041,-1190016.7520833334,-1.190096,-1.1900167520833334
481000000,-1188564,-572396605,-1190013.7318087318,-1.188564,-1.1900137318087318
482000000,-1191067,-573587672,-1190015.9170124482,-1.191067,-1.1900159170124482
483000000,-1191493,-574779165,-1190018.9751552795,-1.191493,-1.1900189751552794
484000000,-1191051,-575970216,-1190021.1074380165,-1.191051,-1.1900211074380165
485000000,-1191177,-577161393,-1190023.4907216495,-1.191177,-1.1900234907216496
486000000,-1191771,-578353164,-1190027.086419753,-1.191771,-1.190027086419753
487000000,-1191843,-579545007,-1190030.815195072,-1.191843,-1.1900308151950718
488000000,-1190050,-580735057,-1190030.8545081967,-1.19005,-1.1900308545081968
489000000,-1191221,-581926278,-1190033.2883435583,-1.191221,-1.1900332883435583
490000000,-1193989,-583120267,-1190041.3612244898,-1.193989,-1.1900413612244898
491000000,-1193325,-584313592,-1190048.0488798372,-1.193325,-1.190048048879837
492000000,-1190074,-585503666,-1190048.1016260162,-1.190074,-1.1900481016260163
493000000,-1190976,-586694642,-1190049.9837728194,-1.190976,-1.1900499837728196
494000000,-1187620,-587882262,-1190045.064777328,-1.18762,-1.190045064777328
495000000,-1192242,-589074504,-1190049.503030303,-1.192242,-1.190049503030303
496000000,-1189561,-590264065,-1190048.5181451612,-1.189561,-1.1900485181451612
497000000,-1188300,-591452365,-1190045.0,-1.1883,-1.190045
498000000,-1190559,-592642924,-1190046.032128514,-1.190559,-1.190046032128514
499000000,-1188767,-593831691,-1190043.4689378757,-1.188767,-1.1900434689378758
500000000,-1189983,-595021674,-1190043.348,-1.189983,-1.190043348
501000000,-1191806,-596213480,-1190046.866267465,-1.191806,-1.190046866267465
502000000,-1193338,-597406818,-1190053.422310757,-1.193338,-1.190053422310757
503000000,-1188091,-598594909,-1190049.5208747515,-1.188091,-1.1900495208747515
504000000,-1192635,-599787544,-1190054.650793651,-1.192635,-1.1900546507936507
505000000,-1190577,-600978121,-1190055.6851485148,-1.190577,-1.190055685148515
506000000,-1191152,-602169273,-1190057.851778656,-1.191152,-1.1900578517786562
507000000,-1189082,-603358355,-1190055.9270216962,-1.189082,-1.1900559270216962
508000000,-1189291,-604547646,-1190054.4212598426,-1.189291,-1.1900544212598425
509000000,-1192800,-605740446,-1190059.815324165,-1.1928,-1.190059815324165
510000000,-1188612,-606929058,-1190056.9764705882,-1.188612,-1.1900569764705882
511000000,-1192446,-608121504,-1190061.6516634051,-1.192446,-1.190061651663405
512000000,-1191504,-609313008,-1190064.46875,-1.191504,-1.19006446875
513000000,-1192661,-610505669,-1190069.530214425,-1.192661,-1.1900695302144249
514000000,-1191563,-611697232,-1190072.4357976653,-1.191563,-1.1900724357976653
515000000,-1189795,-612887027,-1190071.8970873787,-1.189795,-1.1900718970873787
516000000,-1191907,-614078934,-1190075.453488372,-1.191907,-1.1900754534883722
517000000,-1189742,-615268676,-1190074.8085106383,-1.189742,-1.1900748085106383
518000000,-1190896,-616459572,-1190076.3938223938,-1.190896,-1.1900763938223937
519000000,-1187986,-617647558,-1190072.366088632,-1.187986,-1.190072366088632
520000000,-1192190,-618839748,-1190076.4384615384,-1.19219,-1.1900764384615385
521000000,-1186039,-620025787,-1190068.689059501,-1.186039,-1.190068689059501
522000000,-1188016,-621213803,-1190064.7567049807,-1.188016,-1.190064756704981
523000000,-1192164,-622405967,-1190068.7705544934,-1.192164,-1.1900687705544932
524000000,-1189726,-623595693,-1190068.1164122138,-1.189726,-1.1900681164122138
525000000,-1190461,-624786154,-1190068.8647619048,-1.190461,-1.1900688647619047
526000000,-1189802,-625975956,-1190068.3574144486,-1.189802,-1.1900683574144486
527000000,-1190894,-627166850,-1190069.9240986716,-1.190894,-1.1900699240986716
528000000,-1190141,-628356991,-1190070.058712121,-1.190141,-1.1900700587121211
529000000,-1189196,-629546187,-1190068.4064272211,-1.189196,-1.1900684064272211
530000000,-1189666,-630735853,-1190067.6471698114,-1.189666,-1.1900676471698113
531000000,-1188358,-631924211,-1190064.427495292,-1.188358,-1.1900644274952918
532000000,-1189044,-633113255,-1190062.5093984962,-1.189044,-1.1900625093984962
533000000,-1189322,-634302577,-1190061.120075047,-1.189322,-1.1900611200750468
534000000,-1192250,-635494827,-1190065.2191011235,-1.19225,-1.1900652191011236
535000000,-1189432,-636684259,-1190064.0355140187,-1.189432,-1.1900640355140186
536000000,-1187919,-637872178,-1190060.0335820895,-1.187919,-1.1900600335820894
537000000,-1189167,-639061345,-1190058.370577281,-1.189167,-1.1900583705772811
538000000,-1188917,-640250262,-1190056.249070632,-1.188917,-1.190056249070632
539000000,-1190772,-641441034,-1190057.5769944342,-1.190772,-1.1900575769944342
540000000,-1192021,-642633055,-1190061.212962963,-1.192021,-1.1900612129629629
541000000,-1186866,-643819921,-1190055.3068391867,-1.186866,-1.1900553068391866
542000000,-1187243,-645007164,-1190050.1180811808,-1.187243,-1.1900501180811809
543000000,-1186677,-646193841,-1190043.9060773482,-1.186677,-1.190043906077348
544000000,-1189164,-647383005,-1190042.2886029412,-1.189164,-1.1900422886029411
545000000,-1193048,-648576053,-1190047.8036697248,-1.193048,-1.1900478036697248
546000000,-1192388,-649768441,-1190052.0897435897,-1.192388,-1.1900520897435898
547000000,-1188501,-650956942,-1190049.2541133454,-1.188501,-1.1900492541133456
548000000,-1191547,-652148489,-1190051.9872262774,-1.191547,-1.1900519872262774
549000000,-1188328,-653336817,-1190048.8469945355,-1.188328,-1.1900488469945356
550000000,-1190974,-654527791,-1190050.529090909,-1.190974,-1.1900505290909091
551000000,-1193020,-655720811,-1190055.9183303085,-1.19302,-1.1900559183303085
552000000,-1191150,-656911961,-1190057.9003623188,-1.19115,-1.1900579003623188
553000000,-1190000,-658101961,-1190057.7956600362,-1.19,-1.1900577956600362
554000000,-1192031,-659293992,-1190061.357400722,-1.192031,-1.190061357400722
555000000,-1189981,-660483973,-1190061.2126126126,-1.189981,-1.1900612126126127
556000000,-1189887,-661673860,-1190060.8992805756,-1.189887,-1.1900608992805755
557000000,-1191270,-662865130,-1190063.0700179534,-1.19127,-1.1900630700179533
558000000,-1188098,-664053228,-1190059.5483870967,-1.188098,-1.1900595483870968
559000000,-1191193,-665244421,-1190061.5760286225,-1.191193,-1.1900615760286226
560000000,-1190171,-666434592,-1190061.7714285713,-1.190171,-1.1900617714285715
561000000,-1190321,-667624913,-1190062.2335115864,-1.190321,-1.1900622335115865
562000000,-1189844,-668814757,-1190061.8451957295,-1.189844,-1.1900618451957294
563000000,-1189745,-670004502,-1190061.2824156305,-1.189745,-1.1900612824156305
564000000,-1191247,-671195749,-1190063.384751773,-1.191247,-1.190063384751773
565000000,-1189935,-672385684,-1190063.157522124,-1.189935,-1.1900631575221239
566000000,-1190414,-673576098,-1190063.777385159,-1.190414,-1.190063777385159
567000000,-1190669,-674766767,-1190064.8447971782,-1.190669,-1.1900648447971782
568000000,-1189104,-675955871,-1190063.153169014,-1.189104,-1.190063153169014
569000000,-1190071,-677145942,-1190063.1669595782,-1.190071,-1.1900631669595783
570000000,-1187154,-678333096,-1190058.0631578946,-1.187154,-1.1900580631578948
571000000,-1188360,-679521456,-1190055.0893169877,-1.18836,-1.1900550893169877
572000000,-1190036,-680711492,-1190055.055944056,-1.190036,-1.190055055944056
573000000,-1190487,-681901979,-1190055.8097731238,-1.190487,-1.190055809773124
574000000,-1191813,-683093792,-1190058.8710801394,-1.191813,-1.1900588710801394
575000000,-1193058,-684286850,-1190064.0869565217,-1.193058,-1.1900640869565218
576000000,-1190626,-685477476,-1190065.0625,-1.190626,-1.1900650625
577000000,-1186197,-686663673,-1190058.3587521664,-1.186197,-1.1900583587521665
578000000,-1190859,-687854532,-1190059.7439446368,-1.190859,-1.1900597439446368
579000000,-1188631,-689043163,-1190057.2763385146,-1.188631,-1.1900572763385147
580000000,-1189516,-690232679,-1190056.3431034482,-1.189516,-1.1900563431034483
581000000,-1189998,-691422677,-1190056.2426850258,-1.189998,-1.1900562426850259
582000000,-1187797,-692610474,-1190052.3608247424,-1.187797,-1.1900523608247422
583000000,-1191908,-693802382,-1190055.5437392795,-1.191908,-1.1900555437392797
584000000,-1191846,-694994228,-1190058.6095890412,-1.191846,-1.190058609589041
585000000,-1189946,-696184174,-1190058.4170940171,-1.189946,-1.1900584170940172
586000000,-1190399,-697374573,-1190058.9982935153,-1.190399,-1.1900589982935155
587000000,-1191296,-698565869,-1190061.1056218059,-1.191296,-1.1900611056218058
588000000,-1190117,-699755986,-1190061.2006802722,-1.190117,-1.1900612006802722
589000000,-1190833,-700946819,-1190062.5110356538,-1.190833,-1.1900625110356537
590000000,-1188504,-702135323,-1190059.8694915255,-1.188504,-1.1900598694915254
591000000,-1190115,-703325438,-1190059.9627749578,-1.190115,-1.1900599627749577
592000000,-1189842,-704515280,-1190059.5945945946,-1.189842,-1.1900595945945946
593000000,-1190833,-705706113,-1190060.8988195616,-1.190833,-1.1900608988195616
594000000,-1189899,-706896012,-1190060.6262626264,-1.189899,-1.1900606262626263
595000000,-1190822,-708086834,-1190061.905882353,-1.190822,-1.190061905882353
596000000,-1191858,-709278692,-1190064.9194630873,-1.191858,-1.1900649194630872
597000000,-1189627,-710468319,-1190064.1859296483,-1.189627,-1.1900641859296481
598000000,-1189771,-711658090,-1190063.6956521738,-1.189771,-1.190063695652174
599000000,-1192614,-712850704,-1190067.9532554257,-1.192614,-1.1900679532554257
600000000,-1188993,-714039697,-1190066.1616666666,-1.188993,-1.1900661616666666
601000000,-1191660,-715231357,-1190068.8136439268,-1.19166,-1.1900688136439268
602000000,-1191723,-716423080,-1190071.561461794,-1.191723,-1.190071561461794
603000000,-1188805,-717611885,-1190069.4610281924,-1.188805,-1.1900694610281923
604000000,-1190074,-718801959,-1190069.4685430464,-1.190074,-1.1900694685430464
605000000,-1188271,-719990230,-1190066.4958677685,-1.188271,-1.1900664958677687
606000000,-1189641,-721179871,-1190065.793729373,-1.189641,-1.190065793729373
607000000,-1188675,-722368546,-1190063.5024711697,-1.188675,-1.1900635024711697
608000000,-1188963,-723557509,-1190061.6924342106,-1.188963,-1.1900616924342104
609000000,-1188690,-724746199,-1190059.4400656815,-1.18869,-1.1900594400656814
610000000,-1188546,-725934745,-1190056.9590163934,-1.188546,-1.1900569590163934
611000000,-1190956,-727125701,-1190058.4304418985,-1.190956,-1.1900584304418986
612000000,-1186598,-728312299,-1190052.776143791,-1.186598,-1.190052776143791
613000000,-1190749,-729503048,-1190053.911908646,-1.190749,-1.190053911908646
614000000,-1191074,-730694122,-1190055.5732899022,-1.191074,-1.1900555732899023
615000000,-1189952,-731884074,-1190055.4048780487,-1.189952,-1.1900554048780487
616000000,-1188410,-733072484,-1190052.7337662338,-1.18841,-1.1900527337662337
617000000,-1187825,-734260309,-1190049.1231766613,-1.187825,-1.1900491231766612
618000000,-1188765,-735449074,-1190047.0453074435,-1.188765,-1.1900470453074434
619000000,-1188865,-736637939,-1190045.1357027465,-1.188865,-1.1900451357027464
620000000,-1190010,-737827949,-1190045.0790322581,-1.19001,-1.190045079032258
621000000,-1192297,-739020246,-1190048.7053140097,-1.192297,-1.1900487053140096
622000000,-1192332,-740212578,-1190052.3762057878,-1.192332,-1.1900523762057877
623000000,-1189950,-741402528,-1190052.2118780096,-1.18995,-1.1900522118780097
624000000,-1189652,-742592180,-1190051.5705128205,-1.189652,-1.1900515705128205
625000000,-1192270,-743784450,-1190055.12,-1.19227,-1.19005512
626000000,-1190681,-744975131,-1190056.1198083067,-1.190681,-1.1900561198083066
627000000,-1190694,-746165825,-1190057.1371610845,-1.190694,-1.1900571371610846
628000000,-1187987,-747353812,-1190053.8407643312,-1.187987,-1.1900538407643313
629000000,-1192680,-748546492,-1190058.0158982512,-1.19268,-1.1900580158982512
630000000,-1191622,-749738114,-1190060.4984126985,-1.191622,-1.1900604984126983
631000000,-1187598,-750925712,-1190056.5958795561,-1.187598,-1.1900565958795564
632000000,-1191285,-752116997,-1190058.539556962,-1.191285,-1.190058539556962
633000000,-1191455,-753308452,-1190060.7456556081,-1.191455,-1.1900607456556083
634000000,-1191949,-754500401,-1190063.7239747634,-1.191949,-1.1900637239747633
635000000,-1194554,-755694955,-1190070.7952755906,-1.194554,-1.1900707952755905
636000000,-1188969,-756883924,-1190069.0628930817,-1.188969,-1.1900690628930817
637000000,-1190885,-758074809,-1190070.343799058,-1.190885,-1.190070343799058
638000000,-1192639,-759267448,-1190074.369905956,-1.192639,-1.1900743699059562
639000000,-1188765,-760456213,-1190072.3208137716,-1.188765,-1.1900723208137716
640000000,-1192446,-761648659,-1190076.0296875,-1.192446,-1.1900760296875
641000000,-1189588,-762838247,-1190075.2683307333,-1.189588,-1.1900752683307332
642000000,-1187815,-764026062,-1190071.7476635515,-1.187815,-1.1900717476635514
643000000,-1190247,-765216309,-1190072.0202177295,-1.190247,-1.1900720202177293
644000000,-1191154,-766407463,-1190073.700310559,-1.191154,-1.190073700310559
645000000,-1186790,-767594253,-1190068.6093023256,-1.18679,-1.1900686093023256
646000000,-1186289,-768780542,-1190062.7585139319,-1.186289,-1.1900627585139318
647000000,-1193661,-769974203,-1190068.3199381763,-1.193661,-1.1900683199381763
648000000,-1190001,-771164204,-1190068.2160493827,-1.190001,-1.1900682160493827
649000000,-1188863,-772353067,-1190066.3590138676,-1.188863,-1.1900663590138676
650000000,-1191457,-773544524,-1190068.4984615385,-1.191457,-1.1900684984615384
651000000,-1191074,-774735598,-1190070.0430107526,-1.191074,-1.1900700430107527
652000000,-1190251,-775925849,-1190070.3205521472,-1.190251,-1.1900703205521472
653000000,-1190908,-777116757,-1190071.6033690658,-1.190908,-1.190071603369066
654000000,-1189027,-778305784,-1190070.006116208,-1.189027,-1.190070006116208
655000000,-1189622,-779495406,-1190069.3221374045,-1.189622,-1.1900693221374046
656000000,-1191377,-780686783,-1190071.3155487804,-1.191377,-1.1900713155487805
657000000,-1190833,-781877616,-1190072.4748858449,-1.190833,-1.1900724748858447
658000000,-1189099,-783066715,-1190070.9954407294,-1.189099,-1.1900709954407296
659000000,-1189618,-784256333,-1190070.3080424885,-1.189618,-1.1900703080424886
660000000,-1192256,-785448589,-1190073.6196969696,-1.192256,-1.1900736196969697
661000000,-1190141,-786638730,-1190073.721633888,-1.190141,-1.1900737216338881
662000000,-1188132,-787826862,-1190070.7885196374,-1.188132,-1.1900707885196375
663000000,-1192620,-789019482,-1190074.6334841629,-1.19262,-1.190074633484163
664000000,-1190623,-790210105,-1190075.4593373493,-1.190623,-1.1900754593373495
665000000,-1190131,-791400236,-1190075.5428571429,-1.190131,-1.1900755428571428
666000000,-1189623,-792589859,-1190074.8633633633,-1.189623,-1.1900748633633633
667000000,-1192271,-793782130,-1190078.155922039,-1.192271,-1.190078155922039
668000000,-1188917,-794971047,-1190076.4176646706,-1.188917,-1.1900764176646708
669000000,-1188277,-796159324,-1190073.7279521674,-1.188277,-1.1900737279521674
670000000,-1191222,-797350546,-1190075.4417910448,-1.191222,-1.1900754417910449
671000000,-1192873,-798543419,-1190079.611028316,-1.192873,-1.190079611028316
672000000,-1191409,-799734828,-1190081.5892857143,-1.191409,-1.1900815892857144
673000000,-1189038,-800923866,-1190080.0386329866,-1.189038,-1.1900800386329866
674000000,-1190247,-802114113,-1190080.2863501483,-1.190247,-1.1900802863501483
675000000,-1192755,-803306868,-1190084.2488888889,-1.192755,-1.190084248888889
676000000,-1189775,-804496643,-1190083.7914201184,-1.189775,-1.1900837914201183
677000000,-1191812,-805688455,-1190086.3441654358,-1.191812,-1.1900863441654357
678000000,-1190747,-806879202,-1190087.3185840708,-1.190747,-1.1900873185840708
679000000,-1190826,-808070028,-1190088.406480118,-1.190826,-1.1900884064801178
680000000,-1187944,-809257972,-1190085.2529411765,-1.187944,-1.1900852529411765
681000000,-1189179,-810447151,-1190083.9221732747,-1.189179,-1.1900839221732746
682000000,-1186962,-811634113,-1190079.34457478,-1.186962,-1.1900793445747802
683000000,-1191888,-812826001,-1190081.992679356,-1.191888,-1.1900819926793558
684000000,-1191019,-814017020,-1190083.3625730993,-1.191019,-1.1900833625730993
685000000,-1190976,-815207996,-1190084.6656934307,-1.190976,-1.1900846656934307
686000000,-1189063,-816397059,-1190083.1763848397,-1.189063,-1.1900831763848396
687000000,-1191934,-817588993,-1190085.8704512373,-1.191934,-1.1900858704512374
688000000,-1189624,-818778617,-1190085.199127907,-1.189624,-1.190085199127907
689000000,-1188616,-819967233,-1190083.0667634252,-1.188616,-1.1900830667634252
690000000,-1191333,-821158566,-1190084.8782608695,-1.191333,-1.1900848782608695
691000000,-1189595,-822348161,-1190084.1693198264,-1.189595,-1.1900841693198263
692000000,-1189014,-823537175,-1190082.62283237,-1.189014,-1.19008262283237
693000000,-1190320,-824727495,-1190082.9653679654,-1.19032,-1.1900829653679654
694000000,-1191712,-825919207,-1190085.3126801152,-1.191712,-1.1900853126801152
695000000,-1189242,-827108449,-1190084.0992805755,-1.189242,-1.1900840992805755
696000000,-1186324,-828294773,-1190078.6968390804,-1.186324,-1.1900786968390804
697000000,-1190472,-829485245,-1190079.2611190819,-1.190472,-1.1900792611190818
698000000,-1190693,-830675938,-1190080.1404011461,-1.190693,-1.190080140401146
699000000,-1189978,-831865916,-1190079.9942775394,-1.189978,-1.1900799942775393
700000000,-1189634,-833055550,-1190079.357142857,-1.189634,-1.1900793571428572
701000000,-1192618,-834248168,-1190082.9786019973,-1.192618,-1.190082978601997
702000000,-1189953,-835438121,-1190082.7934472933,-1.189953,-1.1900827934472935
703000000,-1187848,-836625969,-1190079.614509246,-1.187848,-1.190079614509246
704000000,-1187954,-837813923,-1190076.5951704546,-1.187954,-1.1900765951704546
705000000,-1189850,-839003773,-1190076.2737588652,-1.18985,-1.1900762737588653
706000000,-1189884,-840193657,-1190076.0014164306,-1.189884,-1.1900760014164307
707000000,-1192330,-841385987,-1190079.189533239,-1.19233,-1.190079189533239
708000000,-1189358,-842575345,-1190078.170903955,-1.189358,-1.1900781709039547
709000000,-1190329,-843765674,-1190078.5246826515,-1.190329,-1.1900785246826515
710000000,-1191958,-844957632,-1190081.171830986,-1.191958,-1.1900811718309858
711000000,-1191046,-846148678,-1190082.52883263,-1.191046,-1.19008252883263
712000000,-1188116,-847336794,-1190079.7668539325,-1.188116,-1.1900797668539327
713000000,-1190076,-848526870,-1190079.7615708276,-1.190076,-1.1900797615708274
714000000,-1189464,-849716334,-1190078.8991596638,-1.189464,-1.1900788991596638
715000000,-1190061,-850906395,-1190078.8741258741,-1.190061,-1.190078874125874
716000000,-1186166,-852092561,-1190073.409217877,-1.186166,-1.190073409217877
717000000,-1188732,-853281293,-1190071.5383542539,-1.188732,-1.190071538354254
718000000,-1188782,-854470075,-1190069.742339833,-1.188782,-1.1900697423398328
719000000,-1191160,-855661235,-1190071.2586926287,-1.19116,-1.1900712586926288
720000000,-1188877,-856850112,-1190069.6,-1.188877,-1.1900696
721000000,-1189627,-858039739,-1190068.9861303745,-1.189627,-1.1900689861303744
722000000,-1190367,-859230106,-1190069.3988919668,-1.190367,-1.1900693988919668
723000000,-1190746,-860420852,-1190070.3347164593,-1.190746,-1.1900703347164592
724000000,-1191461,-861612313,-1190072.2555248619,-1.191461,-1.190072255524862
725000000,-1190515,-862802828,-1190072.8662068965,-1.190515,-1.1900728662068965
726000000,-1188694,-863991522,-1190070.9669421487,-1.188694,-1.1900709669421488
727000000,-1190480,-865182002,-1190071.52957359,-1.19048,-1.1900715295735902
728000000,-1188930,-866370932,-1190069.9615384615,-1.18893,-1.1900699615384616
729000000,-1192818,-867563750,-1190073.731138546,-1.192818,-1.1900737311385459
730000000,-1190828,-868754578,-1190074.7643835617,-1.190828,-1.1900747643835616
731000000,-1190880,-869945458,-1190075.8659370726,-1.19088,-1.1900758659370725
732000000,-1187387,-871132845,-1190072.1926229508,-1.187387,-1.1900721926229507
733000000,-1191978,-872324823,-1190074.792633015,-1.191978,-1.190074792633015
734000000,-1187816,-873512639,-1190071.7152588556,-1.187816,-1.1900717152588556
735000000,-1190473,-874703112,-1190072.26122449,-1.190473,-1.1900722612244898
736000000,-1189758,-875892870,-1190071.8342391304,-1.189758,-1.1900718342391305
737000000,-1188403,-877081273,-1190069.5698778834,-1.188403,-1.1900695698778834
738000000,-1191103,-878272376,-1190070.970189702,-1.191103,-1.1900709701897019
739000000,-1189046,-879461422,-1190069.5832205683,-1.189046,-1.1900695832205683
740000000,-1188284,-880649706,-1190067.1702702702,-1.188284,-1.1900671702702703
741000000,-1186435,-881836141,-1190062.2685560053,-1.186435,-1.1900622685560054
742000000,-1188373,-883024514,-1190059.9919137466,-1.188373,-1.1900599919137467
743000000,-1190575,-884215089,-1190060.6850605654,-1.190575,-1.1900606850605653
744000000,-1190709,-885405798,-1190061.5564516129,-1.190709,-1.1900615564516128
745000000,-1189013,-886594811,-1190060.1489932886,-1.189013,-1.1900601489932885
746000000,-1189620,-887784431,-1190059.5589812333,-1.18962,-1.1900595589812333
747000000,-1192627,-888977058,-1190062.9959839357,-1.192627,-1.1900629959839357
748000000,-1187886,-890164944,-1190060.0855614974,-1.187886,-1.1900600855614973
749000000,-1188282,-891353226,-1190057.7116154872,-1.188282,-1.1900577116154873
750000000,-1190688,-892543914,-1190058.552,-1.190688,-1.190058552
751000000,-1192285,-893736199,-1190061.5166444741,-1.192285,-1.1900615166444741
752000000,-1190579,-894926778,-1190062.204787234,-1.190579,-1.190062204787234
753000000,-1189078,-896115856,-1190060.8977423639,-1.189078,-1.190060897742364
754000000,-1191191,-897307047,-1190062.396551724,-1.191191,-1.190062396551724
755000000,-1189629,-898496676,-1190061.8225165564,-1.189629,-1.1900618225165562
756000000,-1190643,-899687319,-1190062.5912698412,-1.190643,-1.1900625912698413
757000000,-1191322,-900878641,-1190064.2549537648,-1.191322,-1.1900642549537648
758000000,-1191818,-902070459,-1190066.5686015831,-1.191818,-1.1900665686015832
759000000,-1191034,-903261493,-1190067.8432147563,-1.191034,-1.1900678432147562
760000000,-1188916,-904450409,-1190066.327631579,-1.188916,-1.190066327631579
761000000,-1187143,-905637552,-1190062.4862023653,-1.187143,-1.1900624862023652
762000000,-1189450,-906827002,-1190061.6824146982,-1.18945,-1.1900616824146981
763000000,-1190180,-908017182,-1190061.8374836172,-1.19018,-1.1900618374836174
764000000,-1189161,-909206343,-1190060.6583769633,-1.189161,-1.1900606583769633
765000000,-1189725,-910396068,-1190060.219607843,-1.189725,-1.1900602196078431
766000000,-1190746,-911586814,-1190061.1148825064,-1.190746,-1.1900611148825064
767000000,-1190997,-912777811,-1190062.3350717078,-1.190997,-1.1900623350717079
768000000,-1190409,-913968220,-1190062.7864583333,-1.190409,-1.1900627864583333
769000000,-1190229,-915158449,-1190063.0026007802,-1.190229,-1.1900630026007801
770000000,-1190129,-916348578,-1190063.0883116883,-1.190129,-1.1900630883116883
771000000,-1191807,-917540385,-1190065.3501945524,-1.191807,-1.1900653501945526
772000000,-1190183,-918730568,-1190065.5025906735,-1.190183,-1.1900655025906737
773000000,-1188752,-919919320,-1190063.8033635188,-1.188752,-1.1900638033635187
774000000,-1189159,-921108479,-1190062.634366925,-1.189159,-1.1900626343669252
775000000,-1191087,-922299566,-1190063.9561290322,-1.191087,-1.1900639561290323
776000000,-1188933,-923488499,-1190062.4987113401,-1.188933,-1.1900624987113402
777000000,-1190610,-924679109,-1190063.2033462033,-1.19061,-1.1900632033462033
778000000,-1190157,-925869266,-1190063.323907455,-1.190157,-1.190063323907455
779000000,-1187278,-927056544,-1190059.7483953787,-1.187278,-1.1900597483953788
780000000,-1190297,-928246841,-1190060.0525641025,-1.190297,-1.1900600525641025
781000000,-1190355,-929437196,-1190060.4302176696,-1.190355,-1.1900604302176696
782000000,-1191132,-930628328,-1190061.800511509,-1.191132,-1.190061800511509
783000000,-1191316,-931819644,-1190063.4022988505,-1.191316,-1.1900634022988505
784000000,-1190419,-933010063,-1190063.855867347,-1.190419,-1.1900638558673469
785000000,-1187381,-934197444,-1190060.4382165605,-1.187381,-1.1900604382165605
786000000,-1191068,-935388512,-1190061.7201017812,-1.191068,-1.1900617201017811
787000000,-1194919,-936583431,-1190067.8919949173,-1.194919,-1.1900678919949175
788000000,-1190818,-937774249,-1190068.8439086294,-1.190818,-1.1900688439086295
789000000,-1194509,-938968758,-1190074.4714828897,-1.194509,-1.1900744714828897
790000000,-1191496,-940160254,-1190076.270886076,-1.191496,-1.190076270886076
791000000,-1189414,-941349668,-1190075.4336283186,-1.189414,-1.1900754336283186
792000000,-1187929,-942537597,-1190072.7234848484,-1.187929,-1.1900727234848485
793000000,-1189313,-943726910,-1190071.765447667,-1.189313,-1.1900717654476671
794000000,-1191561,-944918471,-1190073.6410579346,-1.191561,-1.1900736410579345
795000000,-1191199,-946109670,-1190075.0566037735,-1.191199,-1.1900750566037737
796000000,-1189374,-947299044,-1190074.175879397,-1.189374,-1.190074175879397
797000000,-1191874,-948490918,-1190076.43412798,-1.191874,-1.19007643412798
798000000,-1190916,-949681834,-1190077.4862155388,-1.190916,-1.1900774862155388
799000000,-1188316,-950870150,-1190075.2816020024,-1.188316,-1.1900752816020026
800000000,-1190653,-952060803,-1190076.00375,-1.190653,-1.19007600375
801000000,-1190059,-953250862,-1190075.9825218476,-1.190059,-1.1900759825218477
802000000,-1190996,-954441858,-1190077.1296758105,-1.190996,-1.1900771296758104
803000000,-1190148,-955632006,-1190077.217932752,-1.190148,-1.1900772179327521
804000000,-1189157,-956821163,-1190076.0733830845,-1.189157,-1.1900760733830846
805000000,-1189137,-958010300,-1190074.906832298,-1.189137,-1.1900749068322982
806000000,-1190827,-959201127,-1190075.8399503722,-1.190827,-1.1900758399503721
807000000,-1189403,-960390530,-1190075.0061957869,-1.189403,-1.1900750061957868
808000000,-1188942,-961579472,-1190073.603960396,-1.188942,-1.190073603960396
809000000,-1190367,-962769839,-1190073.9666254635,-1.190367,-1.1900739666254636
810000000,-1189083,-963958922,-1190072.7432098766,-1.189083,-1.1900727432098765
811000000,-1190576,-965149498,-1190073.3637484587,-1.190576,-1.1900733637484586
812000000,-1188363,-966337861,-1190071.2573891627,-1.188363,-1.1900712573891625
813000000,-1188776,-967526637,-1190069.664206642,-1.188776,-1.1900696642066422
814000000,-1189406,-968716043,-1190068.8488943488,-1.189406,-1.190068848894349
815000000,-1190884,-969906927,-1190069.8490797547,-1.190884,-1.1900698490797545
816000000,-1190571,-971097498,-1190070.4632352942,-1.190571,-1.190070463235294
817000000,-1192056,-972289554,-1190072.8935128518,-1.192056,-1.190072893512852
818000000,-1189003,-973478557,-1190071.5855745722,-1.189003,-1.190071585574572
819000000,-1190999,-974669556,-1190072.717948718,-1.190999,-1.190072717948718
820000000,-1188924,-975858480,-1190071.3170731708,-1.188924,-1.1900713170731707
821000000,-1188599,-977047079,-1190069.5237515226,-1.188599,-1.1900695237515226
822000000,-1190822,-978237901,-1190070.4391727494,-1.190822,-1.1900704391727495
823000000,-1190422,-979428323,-1190070.8663426489,-1.190422,-1.190070866342649
824000000,-1186272,-980614595,-1190066.2560679612,-1.186272,-1.1900662560679611
825000000,-1192089,-981806684,-1190068.7078787878,-1.192089,-1.190068707878788
826000000,-1192699,-982999383,-1190071.8922518159,-1.192699,-1.190071892251816
827000000,-1189788,-984189171,-1190071.5489721887,-1.189788,-1.1900715489721887
828000000,-1194538,-985383709,-1190076.943236715,-1.194538,-1.1900769432367149
829000000,-1191859,-986575568,-1190079.0928829915,-1.191859,-1.1900790928829916
830000000,-1190181,-987765749,-1190079.2156626505,-1.190181,-1.1900792156626505
831000000,-1188772,-988954521,-1190077.642599278,-1.188772,-1.190077642599278
832000000,-1189906,-990144427,-1190077.436298077,-1.189906,-1.1900774362980768
833000000,-1190028,-991334455,-1190077.3769507804,-1.190028,-1.1900773769507804
834000000,-1190519,-992524974,-1190077.90647482,-1.190519,-1.1900779064748201
835000000,-1189094,-993714068,-1190076.7281437125,-1.189094,-1.1900767281437126
836000000,-1192499,-994906567,-1190079.625598086,-1.192499,-1.190079625598086
837000000,-1190204,-996096771,-1190079.7741935484,-1.190204,-1.1900797741935485
838000000,-1190115,-997286886,-1190079.8162291169,-1.190115,-1.1900798162291168
839000000,-1190736,-998477622,-1190080.5983313469,-1.190736,-1.190080598331347
840000000,-1189043,-999666665,-1190079.363095238,-1.189043,-1.190079363095238
841000000,-1192370,-1000859035,-1190082.086801427,-1.19237,-1.1900820868014268
842000000,-1187861,-1002046896,-1190079.4489311164,-1.187861,-1.1900794489311164
843000000,-1193069,-1003239965,-1190082.9952550416,-1.193069,-1.1900829952550416
844000000,-1189167,-1004429132,-1190081.9099526065,-1.189167,-1.1900819099526065
845000000,-1191910,-1005621042,-1190084.073372781,-1.19191,-1.190084073372781
846000000,-1191462,-1006812504,-1190085.7021276595,-1.191462,-1.1900857021276596
847000000,-1191372,-1008003876,-1190087.2207792208,-1.191372,-1.1900872207792208
848000000,-1188506,-1009192382,-1190085.3561320754,-1.188506,-1.1900853561320754
849000000,-1189786,-1010382168,-1190085.003533569,-1.189786,-1.1900850035335688
850000000,-1190403,-1011572571,-1190085.3776470588,-1.190403,-1.1900853776470588
851000000,-1190682,-1012763253,-1190086.0787309047,-1.190682,-1.1900860787309049
852000000,-1188164,-1013951417,-1190083.822769953,-1.188164,-1.190083822769953
853000000,-1189992,-1015141409,-1190083.7151230949,-1.189992,-1.190083715123095
854000000,-1188989,-1016330398,-1190082.4332552694,-1.188989,-1.1900824332552693
855000000,-1188389,-1017518787,-1190080.452631579,-1.188389,-1.190080452631579
856000000,-1189184,-1018707971,-1190079.4053738317,-1.189184,-1.1900794053738317
857000000,-1190177,-1019898148,-1190079.5192532088,-1.190177,-1.1900795192532088
858000000,-1190366,-1021088514,-1190079.8531468532,-1.190366,-1.190079853146853
859000000,-1192728,-1022281242,-1190082.9359720605,-1.192728,-1.1900829359720606
860000000,-1189564,-1023470806,-1190082.3325581395,-1.189564,-1.1900823325581396
861000000,-1189398,-1024660204,-1190081.537746806,-1.189398,-1.1900815377468061
862000000,-1190615,-1025850819,-1190082.156612529,-1.190615,-1.190082156612529
863000000,-1187297,-1027038116,-1190078.9293163384,-1.187297,-1.1900789293163383
864000000,-1187021,-1028225137,-1190075.3900462964,-1.187021,-1.1900753900462964
865000000,-1191251,-1029416388,-1190076.749132948,-1.191251,-1.190076749132948
866000000,-1189892,-1030606280,-1190076.5357967666,-1.189892,-1.1900765357967666
867000000,-1190402,-1031796682,-1190076.9111880045,-1.190402,-1.1900769111880045
868000000,-1188932,-1032985614,-1190075.5921658985,-1.188932,-1.1900755921658985
869000000,-1194413,-1034180027,-1190080.583429229,-1.194413,-1.190080583429229
870000000,-1192051,-1035372078,-1190082.8482758622,-1.192051,-1.190082848275862
871000000,-1190602,-1036562680,-1190083.444316877,-1.190602,-1.190083444316877
872000000,-1190648,-1037753328,-1190084.0917431193,-1.190648,-1.1900840917431192
873000000,-1193619,-1038946947,-1190088.1408934707,-1.193619,-1.1900881408934707
874000000,-1189613,-1040136560,-1190087.5972540046,-1.189613,-1.1900875972540046
875000000,-1188938,-1041325498,-1190086.2834285714,-1.188938,-1.1900862834285715
876000000,-1186865,-1042512363,-1190082.6061643835,-1.186865,-1.1900826061643837
877000000,-1188518,-1043700881,-1190080.8221208665,-1.188518,-1.1900808221208665
878000000,-1191353,-1044892234,-1190082.271070615,-1.191353,-1.190082271070615
879000000,-1189627,-1046081861,-1190081.7531285551,-1.189627,-1.1900817531285552
880000000,-1189592,-1047271453,-1190081.196590909,-1.189592,-1.190081196590909
881000000,-1186721,-1048458174,-1190077.3825198638,-1.186721,-1.1900773825198638
882000000,-1189990,-1049648164,-1190077.283446712,-1.18999,-1.190077283446712
883000000,-1189626,-1050837790,-1190076.772366931,-1.189626,-1.190076772366931
884000000,-1187073,-1052024863,-1190073.3744343892,-1.187073,-1.1900733744343892
885000000,-1187893,-1053212756,-1190070.9107344633,-1.187893,-1.1900709107344634
886000000,-1189274,-1054402030,-1190070.0112866818,-1.189274,-1.1900700112866818
887000000,-1191215,-1055593245,-1190071.3021420517,-1.191215,-1.190071302142052
888000000,-1192814,-1056786059,-1190074.3907657657,-1.192814,-1.1900743907657658
889000000,-1191076,-1057977135,-1190075.5174353207,-1.191076,-1.1900755174353206
890000000,-1194745,-1059171880,-1190080.7640449437,-1.194745,-1.1900807640449438
891000000,-1187316,-1060359196,-1190077.6610549944,-1.187316,-1.1900776610549944
892000000,-1191710,-1061550906,-1190079.4910313901,-1.19171,-1.19007949103139
893000000,-1191193,-1062742099,-1190080.737961926,-1.191193,-1.190080737961926
894000000,-1191560,-1063933659,-1190082.3926174496,-1.19156,-1.1900823926174497
895000000,-1189868,-1065123527,-1190082.1530726256,-1.189868,-1.1900821530726258
896000000,-1189550,-1066313077,-1190081.5591517857,-1.18955,-1.1900815591517857
897000000,-1188024,-1067501101,-1190079.265328874,-1.188024,-1.190079265328874
898000000,-1189211,-1068690312,-1190078.29844098,-1.189211,-1.19007829844098
899000000,-1191783,-1069882095,-1190080.1946607342,-1.191783,-1.1900801946607342
900000000,-1188557,-1071070652,-1190078.5022222223,-1.188557,-1.1900785022222222
901000000,-1188343,-1072258995,-1190076.576026637,-1.188343,-1.190076576026637
902000000,-1194252,-1073453247,-1190081.2050997782,-1.194252,-1.1900812050997782
903000000,-1188193,-1074641440,-1190079.1140642304,-1.188193,-1.1900791140642304
904000000,-1189583,-1075831023,-1190078.5652654867,-1.189583,-1.1900785652654868
905000000,-1190918,-1077021941,-1190079.4928176797,-1.190918,-1.1900794928176797
906000000,-1189835,-1078211776,-1190079.2229580574,-1.189835,-1.1900792229580575
907000000,-1192270,-1079404046,-1190081.638368247,-1.19227,-1.1900816383682469
908000000,-1191928,-1080595974,-1190083.6718061673,-1.191928,-1.1900836718061674
909000000,-1191015,-1081786989,-1190084.696369637,-1.191015,-1.190084696369637
910000000,-1193944,-1082980933,-1190088.9373626374,-1.193944,-1.1900889373626373
911000000,-1190239,-1084171172,-1190089.1020856202,-1.190239,-1.1900891020856201
912000000,-1188787,-1085359959,-1190087.6743421052,-1.188787,-1.1900876743421052
913000000,-1191067,-1086551026,-1190088.746987952,-1.191067,-1.1900887469879518
914000000,-1187176,-1087738202,-1190085.5601750547,-1.187176,-1.1900855601750546
915000000,-1189723,-1088927925,-1190085.1639344261,-1.189723,-1.1900851639344263
916000000,-1188860,-1090116785,-1190083.826419214,-1.18886,-1.190083826419214
917000000,-1192008,-1091308793,-1190085.9247546347,-1.192008,-1.1900859247546347
918000000,-1191829,-1092500622,-1190087.8235294118,-1.191829,-1.1900878235294117
919000000,-1189539,-1093690161,-1190087.2263329707,-1.189539,-1.1900872263329707
920000000,-1188501,-1094878662,-1190085.502173913,-1.188501,-1.190085502173913
921000000,-1191125,-1096069787,-1190086.6308360477,-1.191125,-1.1900866308360478
922000000,-1192184,-1097261971,-1190088.9056399132,-1.192184,-1.1900889056399133
923000000,-1190269,-1098452240,-1190089.1007583966,-1.190269,-1.1900891007583965
924000000,-1190892,-1099643132,-1190089.9696969697,-1.190892,-1.1900899696969698
925000000,-1190785,-1100833917,-1190090.721081081,-1.190785,-1.1900907210810812
926000000,-1188080,-1102021997,-1190088.549676026,-1.18808,-1.1900885496760258
927000000,-1189260,-1103211257,-1190087.6558791802,-1.18926,-1.1900876558791802
928000000,-1188187,-1104399444,-1190085.6077586208,-1.188187,-1.1900856077586206
929000000,-1190777,-1105590221,-1190086.3519913885,-1.190777,-1.1900863519913887
930000000,-1192318,-1106782539,-1190088.7516129033,-1.192318,-1.1900887516129033
931000000,-1191387,-1107973926,-1190090.1460794844,-1.191387,-1.1900901460794844
932000000,-1190638,-1109164564,-1190090.7339055794,-1.190638,-1.1900907339055793
933000000,-1190156,-1110354720,-1190090.803858521,-1.190156,-1.190090803858521
934000000,-1189438,-1111544158,-1190090.1049250534,-1.189438,-1.1900901049250536
935000000,-1185475,-1112729633,-1190085.1689839573,-1.185475,-1.190085168983957
936000000,-1189290,-1113918923,-1190084.3194444445,-1.18929,-1.1900843194444444
937000000,-1191479,-1115110402,-1190085.8078975454,-1.191479,-1.1900858078975454
938000000,-1190377,-1116300779,-1190086.118336887,-1.190377,-1.190086118336887
939000000,-1187808,-1117488587,-1190083.6922257722,-1.187808,-1.190083692225772
940000000,-1191570,-1118680157,-1190085.2734042553,-1.19157,-1.1900852734042553
941000000,-1187455,-1119867612,-1190082.4782146653,-1.187455,-1.1900824782146653
942000000,-1190219,-1121057831,-1190082.6231422506,-1.190219,-1.1900826231422506
943000000,-1189894,-1122247725,-1190082.4231177093,-1.189894,-1.1900824231177094
944000000,-1188003,-1123435728,-1190080.220338983,-1.188003,-1.190080220338983
945000000,-1191538,-1124627266,-1190081.762962963,-1.191538,-1.190081762962963
946000000,-1186985,-1125814251,-1190078.4894291754,-1.186985,-1.1900784894291754
947000000,-1190892,-1127005143,-1190079.348468849,-1.190892,-1.190079348468849
948000000,-1191028,-1128196171,-1190080.3491561182,-1.191028,-1.190080349156118
949000000,-1190043,-1129386214,-1190080.3097997892,-1.190043,-1.1900803097997892
950000000,-1191467,-1130577681,-1190081.7694736843,-1.191467,-1.1900817694736843
951000000,-1188738,-1131766419,-1190080.356466877,-1.188738,-1.190080356466877
952000000,-1191578,-1132957997,-1190081.9296218487,-1.191578,-1.1900819296218488
953000000,-1189675,-1134147672,-1190081.502623295,-1.189675,-1.190081502623295
954000000,-1190462,-1135338134,-1190081.9014675051,-1.190462,-1.1900819014675053
955000000,-1190929,-1136529063,-1190082.7884816753,-1.190929,-1.1900827884816754
956000000,-1188851,-1137717914,-1190081.5,-1.188851,-1.1900815
957000000,-1187847,-1138905761,-1190079.1650992685,-1.187847,-1.1900791650992686
958000000,-1188529,-1140094290,-1190077.5469728601,-1.188529,-1.1900775469728602
959000000,-1192818,-1141287108,-1190080.4045881126,-1.192818,-1.1900804045881126
960000000,-1190422,-1142477530,-1190080.7604166667,-1.190422,-1.1900807604166668
961000000,-1187515,-1143665045,-1190078.0905306973,-1.187515,-1.1900780905306971
962000000,-1189633,-1144854678,-1190077.6278586278,-1.189633,-1.1900776278586278
963000000,-1190948,-1146045626,-1190078.5316718589,-1.190948,-1.1900785316718587
964000000,-1189078,-1147234704,-1190077.4937759335,-1.189078,-1.1900774937759335
965000000,-1189435,-1148424139,-1190076.8279792746,-1.189435,-1.1900768279792746
966000000,-1189183,-1149613322,-1190075.9026915114,-1.189183,-1.1900759026915113
967000000,-1190614,-1150803936,-1190076.4591520166,-1.190614,-1.1900764591520165
968000000,-1191368,-1151995304,-1190077.7933884298,-1.191368,-1.1900777933884297
969000000,-1190482,-1153185786,-1190078.2105263157,-1.190482,-1.1900782105263157
970000000,-1192951,-1154378737,-1190081.1721649484,-1.192951,-1.1900811721649485
971000000,-1191181,-1155569918,-1190082.3048403708,-1.191181,-1.1900823048403708
972000000,-1190382,-1156760300,-1190082.6131687243,-1.190382,-1.1900826131687243
973000000,-1191944,-1157952244,-1190084.5262076054,-1.191944,-1.1900845262076054
974000000,-1187950,-1159140194,-1190082.3347022587,-1.18795,-1.1900823347022587
975000000,-1188254,-1160328448,-1190080.4594871795,-1.188254,-1.1900804594871794
976000000,-1189356,-1161517804,-1190079.7172131147,-1.189356,-1.1900797172131148
977000000,-1189590,-1162707394,-1190079.2159672466,-1.18959,-1.1900792159672466
978000000,-1189622,-1163897016,-1190078.7484662577,-1.189622,-1.1900787484662576
979000000,-1191711,-1165088727,-1190080.4157303371,-1.191711,-1.190080415730337
980000000,-1190320,-1166279047,-1190080.6602040816,-1.19032,-1.1900806602040817
981000000,-1191228,-1167470275,-1190081.8297655454,-1.191228,-1.1900818297655453
982000000,-1190854,-1168661129,-1190082.616089613,-1.190854,-1.190082616089613
983000000,-1192820,-1169853949,-1190085.4008138352,-1.19282,-1.1900854008138353
984000000,-1191108,-1171045057,-1190086.4400406503,-1.191108,-1.1900864400406503
985000000,-1188572,-1172233629,-1190084.9025380712,-1.188572,-1.190084902538071
986000000,-1189869,-1173423498,-1190084.6835699796,-1.189869,-1.1900846835699797
987000000,-1186029,-1174609527,-1190080.574468085,-1.186029,-1.1900805744680851
988000000,-1192722,-1175802249,-1190083.2479757085,-1.192722,-1.1900832479757084
989000000,-1189988,-1176992237,-1190083.1516683518,-1.189988,-1.1900831516683519
990000000,-1188858,-1178181095,-1190081.9141414142,-1.188858,-1.190081914141414
991000000,-1188553,-1179369648,-1190080.3713420788,-1.188553,-1.1900803713420787
992000000,-1188854,-1180558502,-1190079.135080645,-1.188854,-1.1900791350806452
993000000,-1190127,-1181748629,-1190079.183282981,-1.190127,-1.190079183282981
994000000,-1190179,-1182938808,-1190079.2837022133,-1.190179,-1.1900792837022134
995000000,-1192142,-1184130950,-1190081.3567839195,-1.192142,-1.1900813567839197
996000000,-1189281,-1185320231,-1190080.5532128515,-1.189281,-1.1900805532128513
997000000,-1189842,-1186510073,-1190080.3139418254,-1.189842,-1.1900803139418255
998000000,-1187400,-1187697473,-1190077.628256513,-1.1874,-1.190077628256513
999000000,-1191235,-1188888708,-1190078.7867867867,-1.191235,-1.1900787867867868
1000000000,-1189202,-1190077910,-1190077.91,-1.189202,-1.19007791
